YYYYYYYYYYYYYYYYYYYYYYYYYYYYYYYYYYYYYYYYYYYYYYYYYYYYYYYYYYYYYYYYYYYYYYYYYYYYYYYYYYYYYYYYYYYYYYY
YYYYYYYYYYYYYYYYYYYYYYYYYYYYYYYYYYYYYYYYYYYYYYYYYYYYYYYYYYYYYYYYYYYYYYYYYYYYYYYYYYYYYYYYYYYYYYY
YY                                                                                           YY
YY                                                                                           YY
YY                                                                                           YY
YY                                                                                           YY
YY                                                                                           YY
YY                                                                                           YY
YY                                                                                           YY
YY                                                                                           YY
YY                                                                                           YY
YY                                                                                           YY
YY                                                                                           YY
YY                                                                                           YY
YY                                                                                           <Y
YY                                                                                           <Y
YY                                                                                           YY
YY                                                                                           YY
Y>                                                                                           YY
Y>                                                                                           YY
YY                                5                                                          YY
YY                            XXXXXXXXXX                                                     YY
YY       E           3                              4                                        YY
YY               XXXXXXXX                           X            E                           YY
YY                                                  X                                        YY
YY   1              2                               X                          6             YY
YYYYYYYYYYYYYYYYYYYYYYYYYYYYYYYYYYYYYYYYYYYYYYYYYYYYYYYYYYYYYYYYYYYYYYYYYYYYYYYYYYYYYYYY    YYY
YYYYYYYYYYYYYYYYYYYYYYYYYYYYYYYYYYYYYYYYYYYYYYYYYYYYYYYYYYYYYYYYYYYYYYYYYYYYYYYYYYYYYYYY    YYY
YY                                                                                     X     YY
YY                                                                                  XXXX     YY
YY                                                                                     X     YY
YY                                                                                           YY
YY                                                                                  XVVX     YY
YY                                                                                           YY
YY                                                                                    8      YY
YY                                                                                  XXXX     YY
YY                                                                                           YY
YY                                                                                    E      YY
YY                                                                                  XXXX     YY
YY                                                                                           YY
YY                                                                                           YY
YY                                                                                  XXXX     YY
YY                                                                                           YY
YY                                                                                           YY
YY                                                                                    7      YY
YY                                                                                  XXXX     YY
YY                                   0                                                       YY
YY                            XXXXXXXXXX                                                     YY
YY                                                                                  XXXX     YY
YY               XXXXXXXX                           X                                        YY
YY                  E  E                            X                                        YY
YY                   E                           9  X                                        YY
YYY^^^^^^^^^YYYYYYYYYYYYYYYYYYYYYYYYYYYYYYYYYYYYYYYYYYYYYYYYYYYYYYYYYYYYYYYYYYYYYYYYYYYYYYYYYYY
YYYYYYYYYYYYYYYYYYYYYYYYYYYYYYYYYYYYYYYYYYYYYYYYYYYYYYYYYYYYYYYYYYYYYYYYYYYYYYYYYYYYYYYYYYYYYYY
