MMMMMMMMMMMMMMMMMMMMMMMMMMMMMMMMMMMMMMMMMMMMMMMMMMMMMMMMMMMMMMMMMMMMMMMMMMMMMMMMMMMMMMMMMMMMMMM
M                                                                                             M
M                                                                                             M
M                                                                                             M
M                                                                                             M
M                                                                                             M
M                                                                                             M
M                                                                                             M
M                                                                                             M
M                                                                                             M
M                                                                                             M
M                                                                                             M
M                                                                                             M
M                                                                                             M
M                                                                                             M
M                                                                                             M
M                                                                                             M
M                                                                                             M
M                                                                                             M
M                                                                                             M
M                                 5                                                           M
M        E                    XXXXXXXXXX                                                      M
M                    3                              4                                         M
M                XXXXXXXX                           X            E                            M
M                                                   X                                         M
M    1              2                               X                          6              M
MMMMMMMMMMMMMMMMMMMMMMMMMMMMMMMMMMMMMMMMMMMMMMMMMMMMMMMMMMMMMMMMMMMMMMMMMMMMMMMMMMMMMMMM     MM
MMMMMMMMMMMMMMMMMMMMMMMMMMMMMMMMMMMMMMMMMMMMMMMMMMMMMMMMMMMMMMMMMMMMMMMMMMMMMMMMMMMMMMMM     MM
M                                                                                             M
M                                                                                             M
M                                                                                             M
M                                                                                             M
M                                                                                             M
M                                                                                             M
M                                                                                             M
M                                                                                             M
M                                                                                             M
M                                                                                             M
M                                                                                             M
M                                                                                             M
M                                                                                             M
M                                                                                             M
M                                                                                             M
M                                                                                             M
M                                                                                             M
M                                                                                             M
M                                                                                             M
M                                                                                             M
M                             XXXXXXXXXX                                                      M
M                                                                                             M
M                XXXXXXXX                           X                                         M
M                                                   X                                         M
M                                                   X                                         M
MMMMMMMMMMMMMMMMMMMMMMMMMMMMMMMMMMMMMMMMMMMMMMMMMMMMMMMMMMMMMMMMMMMMMMMMMMMMMMMMMMMMMMMMMMMMMMM
